Suisse Schweiz Switzerland Svizzera'
Aadorf	Thurgau
Aarau	Aargau
Aarberg	Bern
Aarburg	Aargau
Aarwangen	Bern
Abtwil	Aargau
Aclens	Vaud
Acquarossa	Ticino
Adelboden	Bern
Adligenswil	Lucerne
Adlikon	Zürich
Adliswil	Zürich
Aedermannsdorf	Solothurn
Aefligen	Bern
Aegerten	Bern
Aesch (BL)	Basel-Landschaft
Aesch (LU)	Lucerne
Aesch (ZH)	Zürich
Aeschi (SO)	Solothurn
Aeschi bei Spiez	Bern
Aetigkofen	Solothurn
Aetingen	Solothurn
Aeugst am Albis	Zürich
Affeltrangen	Thurgau
Affoltern am Albis	Zürich
Affoltern im Emmental	Bern
Agarn	Valais
Agiez	Vaud
Agno	Ticino
Aigle	Vaud
Aire-la-Ville	Geneva
Airolo	Ticino
Alberswil	Lucerne
Albinen	Valais
Alchenstorf	Bern
Allaman	Vaud
Alle	Jura
Allmendingen bei Bern	Bern
Allschwil	Basel-Landschaft
Almens	Graubünden
Alpnach	Obwalden
Alpthal	Schwyz
Altbüron	Lucerne
Altdorf (UR)	Uri
Altendorf	Schwyz
Alterswil	Fribourg
Altikon	Zürich
Altishofen	Lucerne
Altnau	Thurgau
Alto Malcantone	Ticino
Altstätten	St. Gallen
Altwis	Lucerne
Alvaneu	Graubünden
Alvaschein	Graubünden
Amden	St. Gallen
Amlikon-Bissegg	Thurgau
Ammerswil	Aargau
Amriswil	Thurgau
Amsoldingen	Bern
Andeer	Graubünden
Andelfingen	Zürich
Andermatt	Uri
Andiast	Graubünden
Andwil (SG)	St. Gallen
Anières	Geneva
Anniviers	Valais
Anwil	Basel-Landschaft
Anzonico	Ticino
Appenzell	Appenzell Innerrhoden
Apples	Vaud
Aranno	Ticino
Arbaz	Valais
Arbedo-Castione	Ticino
Arboldswil	Basel-Landschaft
Arbon	Thurgau
Arch	Bern
Arconciel	Fribourg
Ardez	Graubünden
Ardon	Valais
Arisdorf	Basel-Landschaft
Aristau	Aargau
Arlesheim	Basel-Landschaft
Arnex-sur-Nyon	Vaud
Arnex-sur-Orbe	Vaud
Arni (AG)	Aargau
Arni (BE)	Bern
Arogno	Ticino
Arosa	Graubünden
Arth	Schwyz
Arvigo	Graubünden
Arzier	Vaud
Ascona	Ticino
Assens	Vaud
Astano	Ticino
Attalens	Fribourg
Attelwil	Aargau
Attinghausen	Uri
Attiswil	Bern
Au (SG)	St. Gallen
Aubonne	Vaud
Auboranges	Fribourg
Auenstein	Aargau
Augst	Basel-Landschaft
Ausserberg	Valais
Auswil	Bern
Autafond	Fribourg
Autigny	Fribourg
Auvernier	Neuchâtel
Auw	Aargau
Avegno Gordevio	Ticino
Avenches	Vaud
Avers	Graubünden
Avry	Fribourg
Avully	Geneva
Avusy	Geneva
Ayent	Valais
Baar	Zug
Bachenbülach	Zürich
Bachs	Zürich
Bad Ragaz	St. Gallen
Bad Zurzach	Aargau
Baden	Aargau
Bagnes	Valais
Baldingen	Aargau
Balerna	Ticino
Balgach	St. Gallen
Ballaigues	Vaud
Ballens	Vaud
Ballwil	Lucerne
Balm bei Günsberg	Solothurn
Balsthal	Solothurn
Baltschieder	Valais
Bangerten	Bern
Bannwil	Bern
Barberêche	Fribourg
Bardonnex	Geneva
Bäretswil	Zürich
Bargen (BE)	Bern
Bargen (SH)	Schaffhausen
Bäriswil	Bern
Bärschwil	Solothurn
Bas-Intyamon	Fribourg
Bas-Vully	Fribourg
Basadingen-Schlattingen	Thurgau
Basel	Basel-Stadt
Basse-Allaine	Jura
Bassecourt	Jura
Bassersdorf	Zürich
Bassins	Vaud
Bätterkinden	Bern
Bättwil	Solothurn
Bauen	Uri
Baulmes	Vaud
Bauma	Zürich
Bavois	Vaud
Beatenberg	Bern
Beckenried	Nidwalden
Bedano	Ticino
Bedigliora	Ticino
Bedretto	Ticino
Beggingen	Schaffhausen
Begnins	Vaud
Beinwil (Freiamt)	Aargau
Beinwil (SO)	Solothurn
Beinwil am See	Aargau
Belfaux	Fribourg
Bellach	Solothurn
Bellerive (VD)	Vaud
Bellevue	Geneva
Bellikon	Aargau
Bellinzona	Ticino
Bellmund	Bern
Bellwald	Valais
Belmont-sur-Lausanne	Vaud
Belmont-sur-Yverdon	Vaud
Belp	Bern
Belpberg	Bern
Belprahon	Bern
Benken (SG)	St. Gallen
Benken (ZH)	Zürich
Bennwil	Basel-Landschaft
Benzenschwil	Aargau
Bercher	Vaud
Berg (SG)	St. Gallen
Berg (TG)	Thurgau
Berg am Irchel	Zürich
Bergdietikon	Aargau
Bergün/Bravuogn	Graubünden
Berikon	Aargau
Beringen	Schaffhausen
Berken	Bern
Berlingen	Thurgau
Bern	Bern
Berneck	St. Gallen
Bernex	Geneva
Berolle	Vaud
Beromünster	Lucerne
Bertschikon bei Attikon	Zürich
Besazio	Ticino
Besenbüren	Aargau
Betten	Valais
Bettenhausen	Bern
Bettens	Vaud
Bettingen	Basel-Stadt
Bettlach	Solothurn
Bettwiesen	Thurgau
Bettwil	Aargau
Beurnevésin	Jura
Bevaix	Neuchâtel
Bever	Graubünden
Bévilard	Bern
Bex	Vaud
Biasca	Ticino
Biberist	Solothurn
Bibern (SO)	Solothurn
Biberstein	Aargau
Bichelsee-Balterswil	Thurgau
Biel-Benken	Basel-Landschaft
Biel/Bienne	Bern
Bière	Vaud
Biezwil	Solothurn
Biglen	Bern
Billens-Hennens	Fribourg
Binn	Valais
Binningen	Basel-Landschaft
Bioggio	Ticino
Bioley-Magnoux	Vaud
Bioley-Orjulaz	Vaud
Birgisch	Valais
Birmensdorf (ZH)	Zürich
Birmenstorf (AG)	Aargau
Birr	Aargau
Birrhard	Aargau
Birrwil	Aargau
Birsfelden	Basel-Landschaft
Birwinken	Thurgau
Bischofszell	Thurgau
Bissone	Ticino
Bister	Valais
Bitsch	Valais
Bivio	Graubünden
Blatten	Valais
Blauen	Basel-Landschaft
Bleienbach	Bern
Bleiken bei Oberdiessbach	Bern
Blenio	Ticino
Blitzingen	Valais
Blonay	Vaud
Blumenstein	Bern
Böbikon	Aargau
Böckten	Basel-Landschaft
Bodio	Ticino
Boécourt	Jura
Bofflens	Vaud
Bogis-Bossey	Vaud
Bogno	Ticino
Bôle	Neuchâtel
Bolken	Solothurn
Bolligen	Bern
Boltigen	Bern
Bonaduz	Graubünden
Boncourt	Jura
Bonfol	Jura
Bönigen	Bern
Boningen	Solothurn
Boniswil	Aargau
Bonstetten	Zürich
Bonvillars	Vaud
Boppelsen	Zürich
Borex	Vaud
Bosco/Gurin	Ticino
Bösingen	Fribourg
Bossonnens	Fribourg
Boswil	Aargau
Bottens	Vaud
Bottenwil	Aargau
Botterens	Fribourg
Bottighofen	Thurgau
Bottmingen	Basel-Landschaft
Böttstein	Aargau
Boudevilliers	Neuchâtel
Boudry	Neuchâtel
Bougy-Villars	Vaud
Boulens	Vaud
Bourg-Saint-Pierre	Valais
Bournens	Vaud
Bourrignon	Jura
Boussens	Vaud
Bovernier	Valais
Bowil	Bern
Bözen	Aargau
Braggio	Graubünden
Braunau	Thurgau
Bregaglia	Graubünden
Breggia	Ticino
Breil/Brigels	Graubünden
Breitenbach	Solothurn
Bremblens	Vaud
Bremgarten (AG)	Aargau
Bremgarten bei Bern	Bern
Brenles	Vaud
Brenzikofen	Bern
Bressaucourt	Jura
Bretigny-sur-Morrens	Vaud
Bretonnières	Vaud
Bretzwil	Basel-Landschaft
Brienz (BE)	Bern
Brienz/Brinzauls	Graubünden
Brienzwiler	Bern
Brig-Glis	Valais
Brione (Verzasca)	Ticino
Brione sopra Minusio	Ticino
Brislach	Basel-Landschaft
Brissago	Ticino
Brittnau	Aargau
Broc	Fribourg
Bronschhofen	St. Gallen
Brot-Dessous	Neuchâtel
Brot-Plamboz	Neuchâtel
Brugg	Aargau
Brügg	Bern
Brügglen	Solothurn
Brunegg	Aargau
Brünisried	Fribourg
Brusino Arsizio	Ticino
Brusio	Graubünden
Brüttelen	Bern
Brütten	Zürich
Bubendorf	Basel-Landschaft
Bubikon	Zürich
Buch (SH)	Schaffhausen
Buch am Irchel	Zürich
Buchberg	Schaffhausen
Buchholterberg	Bern
Buchillon	Vaud
Buchrain	Lucerne
Buchs (AG)	Aargau
Buchs (SG)	St. Gallen
Buchs (ZH)	Zürich
Büchslen	Fribourg
Buckten	Basel-Landschaft
Büetigen	Bern
Bühl bei Aarberg	Bern
Bühler	Appenzell Ausserrhoden
Bülach	Zürich
Bulle	Fribourg
Bullet	Vaud
Bünzen	Aargau
Buochs	Nidwalden
Bürchen	Valais
Bure	Jura
Büren (SO)	Solothurn
Büren an der Aare	Bern
Büren zum Hof	Bern
Burg (AG)	Aargau
Burg im Leimental	Basel-Landschaft
Burgdorf	Bern
Burgistein	Bern
Bürglen (TG)	Thurgau
Bürglen (UR)	Uri
Büron	Lucerne
Bursinel	Vaud
Bursins	Vaud
Burtigny	Vaud
Buseno	Graubünden
Büsserach	Solothurn
Bussigny-près-Lausanne	Vaud
Bussigny-sur-Oron	Vaud
Bussnang	Thurgau
Busswil bei Melchnau	Bern
Bussy (FR)	Fribourg
Bussy-Chardonney	Vaud
Bussy-sur-Moudon	Vaud
Bütschwil	St. Gallen
Büttenhardt	Schaffhausen
Büttikon	Aargau
Buttisholz	Lucerne
Buttwil	Aargau
Buus	Basel-Landschaft
Cademario	Ticino
Cadempino	Ticino
Cadenazzo	Ticino
Cadro	Ticino
Calfreisen	Graubünden
Calpiogna	Ticino
Cama	Graubünden
Camorino	Ticino
Campello	Ticino
Campo (Vallemaggia)	Ticino
Canobbio	Ticino
Capriasca	Ticino
Carabietta	Ticino
Carona	Ticino
Carouge (GE)	Geneva
Carrouge	Vaud
Cartigny, Switzerland	Geneva
Caslano	Ticino
Castaneda	Graubünden
Castel San Pietro	Ticino
Casti-Wergenstein	Graubünden
Castiel	Graubünden
Castrisch	Graubünden
Cauco	Graubünden
Cavagnago	Ticino
Cavigliano	Ticino
Cazis	Graubünden
Celerina/Schlarigna	Graubünden
Céligny	Geneva
Centovalli	Ticino
Cerentino	Ticino
Cerniat (FR)	Fribourg
Cerniaz (VD)	Vaud
Cernier	Neuchâtel
Certara	Ticino
Cevio	Ticino
Châbles	Fribourg
Chabrey	Vaud
Chalais	Valais
Cham	Zug
Chamblon	Vaud
Chamoson	Valais
Champagne	Vaud
Champéry	Valais
Champoz	Bern
Champtauroz	Vaud
Champvent	Vaud
Chancy	Geneva
Chanéaz	Vaud
Chapelle (Glâne)	Fribourg
Chapelle-sur-Moudon	Vaud
Chardonne	Vaud
Charmey	Fribourg
Charrat	Valais
Château-d'Oex	Vaud
Châtel-Saint-Denis	Fribourg
Châtel-sur-Montsalvens	Fribourg
Châtelat	Bern
Châtillens	Vaud
Châtillon (FR)	Fribourg
Châtillon (JU)	Jura
Châtonnaye	Fribourg
Chavannes-de-Bogis	Vaud
Chavannes-des-Bois	Vaud
Chavannes-le-Chêne	Vaud
Chavannes-le-Veyron	Vaud
Chavannes-près-Renens	Vaud
Chavannes-sur-Moudon	Vaud
Chavornay	Vaud
Cheiry	Fribourg
Chêne-Bougeries	Geneva
Chêne-Bourg	Geneva
Chêne-Pâquier	Vaud
Chénens	Fribourg
Chermignon	Valais
Chesalles-sur-Moudon	Vaud
Chesalles-sur-Oron	Vaud
Cheseaux-Noréaz	Vaud
Cheseaux-sur-Lausanne	Vaud
Chéserex	Vaud
Chésopelloz	Fribourg
Chessel	Vaud
Chevilly	Vaud
Chevroux	Vaud
Chexbres	Vaud
Cheyres	Fribourg
Chézard-Saint-Martin	Neuchâtel
Chiasso	Ticino
Chigny	Vaud
Chippis	Valais
Chironico	Ticino
Choulex	Geneva
Chur	Graubünden
Churwalden	Graubünden
Cimadera	Ticino
Clarmont	Vaud
Claro	Ticino
Clavaleyres	Bern
Clos du Doubs	Jura
Coeuve	Jura
Coffrane	Neuchâtel
Coinsins	Vaud
Coldrerio	Ticino
Collex-Bossy	Geneva
Collina d'Oro	Ticino
Collombey-Muraz	Valais
Collonge-Bellerive	Geneva
Collonges	Valais
Cologny	Geneva
Colombier (NE)	Neuchâtel
Colombier (VD)	Vaud
Comano	Ticino
Combremont-le-Grand	Vaud
Combremont-le-Petit	Vaud
Commugny	Vaud
Concise	Vaud
Confignon	Geneva
Constantine	Vaud
Conters im Prättigau	Graubünden
Conthey	Valais
Coppet	Vaud
Corban	Jura
Corbeyrier	Vaud
Corbières	Fribourg
Corcelles (BE)	Bern
Corcelles-Cormondrèche	Neuchâtel
Corcelles-le-Jorat	Vaud
Corcelles-près-Concise	Vaud
Corcelles-près-Payerne	Vaud
Corcelles-sur-Chavornay	Vaud
Corgémont	Bern
Corippo	Ticino
Corminboeuf	Fribourg
Cormoret	Bern
Cornaux	Neuchâtel
Cornol	Jura
Corpataux-Magnedens	Fribourg
Correvon	Vaud
Corseaux	Vaud
Corserey	Fribourg
Corsier (GE)	Geneva
Corsier-sur-Vevey	Vaud
Cortaillod	Neuchâtel
Cortébert	Bern
Cossonay	Vaud
Cottens (FR)	Fribourg
Cottens (VD)	Vaud
Courchapoix	Jura
Courchavon	Jura
Courfaivre	Jura
Courgenay	Jura
Courgevaux	Fribourg
Courlevon	Fribourg
Courrendlin	Jura
Courroux	Jura
Court	Bern
Courtedoux	Jura
Courtelary	Bern
Courtepin	Fribourg
Courtételle	Jura
Crans-près-Céligny	Vaud
Crassier	Vaud
Cremin	Vaud
Crémines	Bern
Cresciano	Ticino
Cressier (FR)	Fribourg
Cressier (NE)	Neuchâtel
Crésuz	Fribourg
Crissier	Vaud
Croglio	Ticino
Cronay	Vaud
Croy	Vaud
Cuarnens	Vaud
Cuarny	Vaud
Cudrefin	Vaud
Cugnasco-Gerra	Ticino
Cugy (FR)	Fribourg
Cugy (VD)	Vaud
Cully	Vaud
Cumbel	Graubünden
Cunter	Graubünden
Cureglia	Ticino
Curio	Ticino
Curtilles	Vaud
Dachsen	Zürich
Dägerlen	Zürich
Dagmersellen	Lucerne
Daillens	Vaud
Dallenwil	Nidwalden
Dällikon	Zürich
Dalpe	Ticino
Damphreux	Jura
Däniken	Solothurn
Dänikon	Zürich
Dardagny	Geneva
Därligen	Bern
Därstetten	Bern
Dättlikon	Zürich
Davos	Graubünden
Degen	Graubünden
Degersheim	St. Gallen
Deisswil bei Münchenbuchsee	Bern
Deitingen	Solothurn
Delémont	Jura
Delley-Portalban	Fribourg
Démoret	Vaud
Denens	Vaud
Denezy	Vaud
Denges	Vaud
Densbüren	Aargau
Derendingen	Solothurn
Develier	Jura
Diegten	Basel-Landschaft
Dielsdorf	Zürich
Diemerswil	Bern
Diemtigen	Bern
Diepflingen	Basel-Landschaft
Diepoldsau	St. Gallen
Dierikon	Lucerne
Diessbach bei Büren	Bern
Diesse	Bern
Diessenhofen	Thurgau
Dietikon	Zürich
Dietlikon	Zürich
Dietwil	Aargau
Dinhard	Zürich
Dintikon	Aargau
Disentis/Mustér	Graubünden
Dittingen	Basel-Landschaft
Dizy	Vaud
Domat/Ems	Graubünden
Dombresson	Neuchâtel
Domdidier	Fribourg
Dommartin	Vaud
Dompierre (FR)	Fribourg
Dompierre (VD)	Vaud
Donat	Graubünden
Donneloye	Vaud
Doppleschwand	Lucerne
Dorénaz	Valais
Dorf	Zürich
Dörflingen	Schaffhausen
Dornach	Solothurn
Dottikon	Aargau
Döttingen	Aargau
Dotzigen	Bern
Dozwil	Thurgau
Dübendorf	Zürich
Düdingen	Fribourg
Duggingen	Basel-Landschaft
Duillier	Vaud
Dulliken	Solothurn
Dully	Vaud
Dürnten	Zürich
Dürrenäsch	Aargau
Dürrenroth	Bern
Duvin	Graubünden
Ebersecken	Lucerne
Ebikon	Lucerne
Ebnat-Kappel	St. Gallen
Échallens	Vaud
Echandens	Vaud
Echarlens	Fribourg
Echichens	Vaud
Éclagnens	Vaud
Eclépens	Vaud
Ecoteaux	Vaud
Écublens	Fribourg
Écublens	Vaud
Ederswiler	Jura
Effingen	Aargau
Egerkingen	Solothurn
Egg	Zürich
Eggenwil	Aargau
Eggerberg	Valais
Eggersriet	St. Gallen
Eggiwil	Bern
Eglisau	Zürich
Egliswil	Aargau
Egnach	Thurgau
Egolzwil	Lucerne
Ehrendingen	Aargau
Eich	Lucerne
Eichberg	St. Gallen
Eiken	Aargau
Einsiedeln	Schwyz
Eischoll	Valais
Eisten	Valais
Elfingen	Aargau
Elgg	Zürich
Ellikon an der Thur	Zürich
Elsau	Zürich
Embd	Valais
Embrach	Zürich
Emmen	Lucerne
Emmetten	Nidwalden
Endingen	Aargau
Engelberg	Obwalden
Enges	Neuchâtel
Engollon	Neuchâtel
Ennetbaden	Aargau
Ennetbürgen	Nidwalden
Ennetmoos	Nidwalden
Entlebuch	Lucerne
Epalinges	Vaud
Épendes	Fribourg
Épendes	Vaud
Epesses	Vaud
Eppenberg-Wöschnau	Solothurn
Epsach	Bern
Eptingen	Basel-Landschaft
Ergisch	Valais
Eriswil	Bern
Eriz	Bern
Erlach	Bern
Erlen	Thurgau
Erlenbach (ZH)	Zürich
Erlenbach im Simmental	Bern
Erlinsbach (AG)	Aargau
Erlinsbach (SO)	Solothurn
Ermatingen	Thurgau
Ermensee	Lucerne
Ernen	Valais
Ernetschwil	St. Gallen
Erschmatt	Valais
Erschwil	Solothurn
Ersigen	Bern
Erstfeld	Uri
Eschenbach (LU)	Lucerne
Eschenbach (SG)	St. Gallen
Eschenz	Thurgau
Eschert	Bern
Eschlikon	Thurgau
Escholzmatt	Lucerne
Essert-Pittet	Vaud
Essert-sous-Champvent	Vaud
Essertes	Vaud
Essertines-sur-Rolle	Vaud
Essertines-sur-Yverdon	Vaud
Estavayer-le-Lac	Fribourg
Etagnières	Vaud
Etoy	Vaud
Ettingen	Basel-Landschaft
Ettiswil	Lucerne
Etzelkofen	Bern
Etziken	Solothurn
Evilard	Bern
Evionnaz	Valais
Evolène	Valais
Eysins	Vaud
Fahrni	Bern
Fahrwangen	Aargau
Fahy	Jura
Faido	Ticino
Falera	Graubünden
Fällanden	Zürich
Faoug	Vaud
Farnern	Bern
Farvagny	Fribourg
Féchy	Vaud
Fehraltorf	Zürich
Fehren	Solothurn
Felben-Wellhausen	Thurgau
Feldbrunnen-St. Niklaus	Solothurn
Felsberg	Graubünden
Fenin-Vilars-Saules	Neuchâtel
Ferden	Valais
Ferenbalm	Bern
Ferlens (VD)	Vaud
Ferpicloz	Fribourg
Ferrera	Graubünden
Ferreyres	Vaud
Fétigny	Fribourg
Feuerthalen	Zürich
Feusisberg	Schwyz
Fey	Vaud
Fideris	Graubünden
Fiesch	Valais
Fieschertal	Valais
Fiez	Vaud
Filisur	Graubünden
Finhaut	Valais
Finsterhennen	Bern
Fischbach	Lucerne
Fischbach-Göslikon	Aargau
Fischenthal	Zürich
Fischingen	Thurgau
Fisibach	Aargau
Fislisbach	Aargau
Flaach	Zürich
Fläsch	Graubünden
Flawil	St. Gallen
Flerden	Graubünden
Flims	Graubünden
Flüelen	Uri
Flühli	Lucerne
Flumenthal	Solothurn
Flums	St. Gallen
Flurlingen	Zürich
Font	Fribourg
Fontainemelon	Neuchâtel
Fontaines (NE)	Neuchâtel
Fontaines-sur-Grandson	Vaud
Fontanezier	Vaud
Fontenais	Jura
Forel (Lavaux)	Vaud
Forel-sur-Lucens	Vaud
Forst-Längenbühl	Bern
Founex	Vaud
Fräschels	Fribourg
Frasco	Ticino
Fraubrunnen	Bern
Frauenfeld	Thurgau
Frauenkappelen	Bern
Freienbach	Schwyz
Freienstein-Teufen	Zürich
Freienwil	Aargau
Freimettigen	Bern
Frenkendorf	Basel-Landschaft
Fresens	Neuchâtel
Fribourg	Fribourg
Frick	Aargau
Froideville	Vaud
Frutigen	Bern
Ftan	Graubünden
Fulenbach	Solothurn
Full-Reuenthal	Aargau
Füllinsdorf	Basel-Landschaft
Fully	Valais
Furna	Graubünden
Fürstenau	Graubünden
Gächlingen	Schaffhausen
Gachnang	Thurgau
Gadmen	Bern
Gais	Appenzell Ausserrhoden
Gaiserwald	St. Gallen
Galgenen	Schwyz
Gallenkirch	Aargau
Galmiz	Fribourg
Gals	Bern
Gambarogno	Ticino
Gampel-Bratsch	Valais
Gampelen	Bern
Gams	St. Gallen
Gänsbrunnen	Solothurn
Gansingen	Aargau
Ganterschwil	St. Gallen
Gebenstorf	Aargau
Gelterfingen	Bern
Gelterkinden	Basel-Landschaft
Geltwil	Aargau
Gempen	Solothurn
Gempenach	Fribourg
Geneva	Geneva
Genolier	Vaud
Genthod	Geneva
Gerlafingen	Solothurn
Geroldswil	Zürich
Gersau	Schwyz
Gerzensee	Bern
Gettnau	Lucerne
Geuensee	Lucerne
Giebenach	Basel-Landschaft
Giez	Vaud
Giffers	Fribourg
Gilly	Vaud
Gimel	Vaud
Gingins	Vaud
Giornico	Ticino
Gipf-Oberfrick	Aargau
Gisikon	Lucerne
Giswil	Obwalden
Giubiasco	Ticino
Givisiez	Fribourg
Givrins	Vaud
Gland	Vaud
Glarus	Glarus
Glarus Nord	Glarus
Glarus Süd	Glarus
Glattfelden	Zürich
Gletterens	Fribourg
Glovelier	Jura
Gnosca	Ticino
Golaten	Bern
Goldach	St. Gallen
Goldingen	St. Gallen
Gollion	Vaud
Gommiswald	St. Gallen
Gondiswil	Bern
Gonten	Appenzell Innerrhoden
Gontenschwil	Aargau
Gordola	Ticino
Gorduno	Ticino
Gorgier	Neuchâtel
Göschenen	Uri
Gossau (SG)	St. Gallen
Gossau (ZH)	Zürich
Gossliwil	Solothurn
Gottlieben	Thurgau
Goumoens-la-Ville	Vaud
Goumoens-le-Jux	Vaud
Graben	Bern
Grabs	St. Gallen
Grächen	Valais
Grafenried	Bern
Grafschaft	Valais
Grancia	Ticino
Grancy	Vaud
Grandcour	Vaud
Grandevent	Vaud
Grandfontaine	Jura
Grandson	Vaud
Grandval	Bern
Grandvaux	Vaud
Grandvillard	Fribourg
Granges (Veveyse)	Fribourg
Granges-Paccot	Fribourg
Granges-près-Marnand	Vaud
Grangettes	Fribourg
Gränichen	Aargau
Gravesano	Ticino
Greifensee	Zürich
Grellingen	Basel-Landschaft
Grenchen	Solothurn
Greng	Fribourg
Grengiols	Valais
Grens	Vaud
Greppen	Lucerne
Gresso	Ticino
Gressy	Vaud
Gretzenbach	Solothurn
Grimisuat	Valais
Grindel	Solothurn
Grindelwald	Bern
Grolley	Fribourg
Grône	Valais
Grono	Graubünden
Grossaffoltern	Bern
Grossdietwil	Lucerne
Grosshöchstetten	Bern
Grosswangen	Lucerne
Grub (AR)	Appenzell Ausserrhoden
Grüningen	Zürich
Grüsch	Graubünden
Gruyères	Fribourg
Gryon	Vaud
Gsteig bei Gstaad	Bern
Gsteigwiler	Bern
Guarda	Graubünden
Gudo	Ticino
Guggisberg	Bern
Gündlischwand	Bern
Günsberg	Solothurn
Guntmadingen	Schaffhausen
Gunzgen	Solothurn
Gurbrü	Bern
Gurmels	Fribourg
Gurtnellen	Uri
Gurzelen	Bern
Guttannen	Bern
Guttet-Feschel	Valais
Güttingen	Thurgau
Gy	Geneva
Habkern	Bern
Habsburg	Aargau
Häfelfingen	Basel-Landschaft
Hagenbuch	Zürich
Hägendorf	Solothurn
Häggenschwil	St. Gallen
Hägglingen	Aargau
Hagneck	Bern
Haldenstein	Graubünden
Hallau	Schaffhausen
Hallwil	Aargau
Halten	Solothurn
Härkingen	Solothurn
Hasle (LU)	Lucerne
Hasle bei Burgdorf	Bern
Hasliberg	Bern
Hauenstein-Ifenthal	Solothurn
Hauptwil-Gottshaus	Thurgau
Hausen (AG)	Aargau
Hausen am Albis	Zürich
Haut-Intyamon	Fribourg
Haut-Vully	Fribourg
Haute-Ajoie	Jura
Hauterive (FR)	Fribourg
Hauterive (NE)	Neuchâtel
Hauteville	Fribourg
Häutligen	Bern
Hedingen	Zürich
Hefenhofen	Thurgau
Heiden	Appenzell Ausserrhoden
Heiligenschwendi	Bern
Heimberg	Bern
Heimenhausen	Bern
Heimiswil	Bern
Heinrichswil-Winistorf	Solothurn
Heitenried	Fribourg
Hellikon	Aargau
Hellsau	Bern
Hemberg	St. Gallen
Hemishofen	Schaffhausen
Hemmiken	Basel-Landschaft
Hendschiken	Aargau
Henggart	Zürich
Henniez	Vaud
Herbetswil	Solothurn
Herbligen	Bern
Herdern	Thurgau
Hérémence	Valais
Hergiswil (NW)	Nidwalden
Hergiswil bei Willisau	Lucerne
Herisau	Appenzell Ausserrhoden
Hermance	Geneva
Hermenches	Vaud
Hermetschwil-Staffeln	Aargau
Hermiswil	Bern
Hermrigen	Bern
Herrliberg	Zürich
Hersberg	Basel-Landschaft
Hersiwil	Solothurn
Herznach	Aargau
Herzogenbuchsee	Bern
Hessigkofen	Solothurn
Hettlingen	Zürich
Hildisrieden	Lucerne
Hilterfingen	Bern
Himmelried	Solothurn
Hindelbank	Bern
Hinterrhein	Graubünden
Hinwil	Zürich
Hirschthal	Aargau
Hirzel	Zürich
Hittnau	Zürich
Hitzkirch	Lucerne
Hochdorf	Lucerne
Hochfelden	Zürich
Höchstetten	Bern
Hochwald	Solothurn
Höfen	Bern
Hofstetten (ZH)	Zürich
Hofstetten bei Brienz	Bern
Hofstetten-Flüh	Solothurn
Hohenrain	Lucerne
Hohentannen	Thurgau
Holderbank (AG)	Aargau
Holderbank (SO)	Solothurn
Hölstein	Basel-Landschaft
Holziken	Aargau
Homberg	Bern
Hombrechtikon	Zürich
Homburg	Thurgau
Honau	Lucerne
Horgen	Zürich
Höri	Zürich
Horn	Thurgau
Hornussen	Aargau
Horrenbach-Buchen	Bern
Horriwil	Solothurn
Horw	Lucerne
Hospental	Uri
Hubersdorf	Solothurn
Humlikon	Zürich
Hundwil	Appenzell Ausserrhoden
Hünenberg	Zug
Hüniken	Solothurn
Hüntwangen	Zürich
Hunzenschwil	Aargau
Hütten	Zürich
Hüttikon	Zürich
Hüttlingen	Thurgau
Huttwil	Bern
Hüttwilen	Thurgau
Icogne	Valais
Iffwil	Bern
Igis	Graubünden
Ilanz	Graubünden
Illgau	Schwyz
Illnau-Effretikon	Zürich
Inden	Valais
Ingenbohl	Schwyz
Inkwil	Bern
Innerthal	Schwyz
Innertkirchen	Bern
Ins	Bern
Interlaken	Bern
Inwil	Lucerne
Ipsach	Bern
Iragna	Ticino
Iseltwald	Bern
Isenthal	Uri
Isérables	Valais
Islisberg	Aargau
Isone	Ticino
Isorno	Ticino
Itingen	Basel-Landschaft
Ittigen	Bern
Jaberg	Bern
Jaun	Fribourg
Jegenstorf	Bern
Jenaz	Graubünden
Jenins	Graubünden
Jens	Bern
Jeuss	Fribourg
Jonen	Aargau
Jongny	Vaud
Jonschwil	St. Gallen
Jouxtens-Mézery	Vaud
Juriens	Vaud
Jussy	Geneva
Kaiseraugst	Aargau
Kaiserstuhl	Aargau
Kaisten	Aargau
Kallern	Aargau
Kallnach	Bern
Kaltbrunn	St. Gallen
Kammersrohr	Solothurn
Kandergrund	Bern
Kandersteg	Bern
Känerkinden	Basel-Landschaft
Kappel (SO)	Solothurn
Kappel am Albis	Zürich
Kappelen	Bern
Kaufdorf	Bern
Kehrsatz	Bern
Kemmental	Thurgau
Kernenried	Bern
Kerns	Obwalden
Kerzers	Fribourg
Kesswil	Thurgau
Kestenholz	Solothurn
Kienberg	Solothurn
Kienersrüti	Bern
Kiesen	Bern
Kilchberg (BL)	Basel-Landschaft
Kilchberg (ZH)	Zürich
Killwangen	Aargau
Kippel	Valais
Kirchberg (BE)	Bern
Kirchberg (SG)	St. Gallen
Kirchdorf (BE)	Bern
Kirchenthurnen	Bern
Kirchleerau	Aargau
Kirchlindach	Bern
Kleinandelfingen	Zürich
Kleinbösingen	Fribourg
Kleinlützel	Solothurn
Klingnau	Aargau
Klosters-Serneus	Graubünden
Kloten	Zürich
Knonau	Zürich
Knutwil	Lucerne
Koblenz	Aargau
Kölliken	Aargau
Köniz	Bern
Konolfingen	Bern
Koppigen	Bern
Kradolf-Schönenberg	Thurgau
Krattigen	Bern
Krauchthal	Bern
Kreuzlingen	Thurgau
Kriechenwil	Bern
Kriegstetten	Solothurn
Kriens	Lucerne
Krinau	St. Gallen
Küblis	Graubünden
Künten	Aargau
Küsnacht (ZH)	Zürich
Küssnacht (SZ)	Schwyz
Küttigen	Aargau
Küttigkofen	Solothurn
Kyburg	Zürich
Kyburg-Buchegg	Solothurn
L'Abbaye	Vaud
L'Abergement	Vaud
L'Isle	Vaud
La Baroche	Jura
La Brévine	Neuchâtel
La Brillaz	Fribourg
La Chaux (Cossonay)	Vaud
La Chaux-de-Fonds	Neuchâtel
La Chaux-des-Breuleux	Jura
La Chaux-du-Milieu	Neuchâtel
La Côte-aux-Fées	Neuchâtel
La Ferrière	Bern
La Folliaz	Fribourg
La Heutte	Bern
La Neuveville	Bern
La Praz	Vaud
La Punt Chamues-ch	Graubünden
La Rippe	Vaud
La Roche	Fribourg
La Sagne	Neuchâtel
La Sarraz	Vaud
La Sonnaz	Fribourg
La Tène	Neuchâtel
La Tour-de-Peilz	Vaud
La Verrerie	Fribourg
Laax	Graubünden
Lachen	Schwyz
Laconnex	Geneva
Ladir	Graubünden
Lajoux (JU)	Jura
Lalden	Valais
Lamboing	Bern
Lamone	Ticino
Lampenberg	Basel-Landschaft
Lancy	Geneva
Landiswil	Bern
Langenbruck	Basel-Landschaft
Langendorf	Solothurn
Langenthal	Bern
Langnau am Albis	Zürich
Langnau im Emmental	Bern
Langrickenbach	Thurgau
Langwies	Graubünden
Lantsch/Lenz	Graubünden
Lauenen	Bern
Lauerz	Schwyz
Läufelfingen	Basel-Landschaft
Laufen	Basel-Landschaft
Laufen-Uhwiesen	Zürich
Laufenburg	Aargau
Laupen	Bern
Laupersdorf	Solothurn
Lauperswil	Bern
Lausanne	Vaud
Lausen	Basel-Landschaft
Lauterbrunnen	Bern
Lauwil	Basel-Landschaft
Lavertezzo	Ticino
Lavey-Morcles	Vaud
Lavigny	Vaud
Lavin	Graubünden
Lavizzara	Ticino
Lax	Valais
Le Bémont (JU)	Jura
Le Cerneux-Péquignot	Neuchâtel
Le Châtelard	Fribourg
Le Chenit	Vaud
Le Flon	Fribourg
Le Glèbe	Fribourg
Le Grand-Saconnex	Geneva
Le Landeron	Neuchâtel
Le Lieu	Vaud
Le Locle	Neuchâtel
Le Mont-sur-Lausanne	Vaud
Le Mouret	Fribourg
Le Noirmont	Jura
Le Pâquier (FR)	Fribourg
Le Pâquier (NE)	Neuchâtel
Le Vaud	Vaud
Léchelles	Fribourg
Leggia	Graubünden
Leibstadt	Aargau
Leimbach (AG)	Aargau
Leissigen	Bern
Lengnau (AG)	Aargau
Lengnau (BE)	Bern
Lengwil	Thurgau
Lenk im Simmental	Bern
Lens	Valais
Lenzburg	Aargau
Les Agettes	Valais
Les Bois	Jura
Les Brenets	Neuchâtel
Les Breuleux	Jura
Les Clées	Vaud
Les Cullayes	Vaud
Les Enfers	Jura
Les Geneveys-sur-Coffrane	Neuchâtel
Les Genevez (JU)	Jura
Les Hauts-Geneveys	Neuchâtel
Les Montets	Fribourg
Les Planchettes	Neuchâtel
Les Ponts-de-Martel	Neuchâtel
Les Tavernes	Vaud
Les Thioleyres	Vaud
Les Verrières	Neuchâtel
Leuggern	Aargau
Leuk	Valais
Leukerbad	Valais
Leutwil	Aargau
Leuzigen	Bern
Leysin	Vaud
Leytron	Valais
Lichtensteig	St. Gallen
Liddes	Valais
Liedertswil	Basel-Landschaft
Liesberg	Basel-Landschaft
Liestal	Basel-Landschaft
Ligerz	Bern
Lignerolle	Vaud
Lignières	Neuchâtel
Ligornetto	Ticino
Limpach	Bern
Lindau	Zürich
Linden	Bern
Linescio	Ticino
Linn	Aargau
Locarno	Ticino
Lodrino	Ticino
Lohn (GR)	Graubünden
Lohn (SH)	Schaffhausen
Lohn-Ammannsegg	Solothurn
Löhningen	Schaffhausen
Lohnstorf	Bern
Lommis	Thurgau
Lommiswil	Solothurn
Lonay	Vaud
Longirod	Vaud
Losone	Ticino
Lostallo	Graubünden
Lostorf	Solothurn
Lotzwil	Bern
Lovatens	Vaud
Loveresse	Bern
Lucens	Vaud
Ludiano	Ticino
Lüen	Graubünden
Lufingen	Zürich
Lugano	Ticino
Lugnez	Jura
Luins	Vaud
Lully (FR)	Fribourg
Lully (VD)	Vaud
Lumbrein	Graubünden
Lumino	Ticino
Lungern	Obwalden
Lupfig	Aargau
Lupsingen	Basel-Landschaft
Lurtigen	Fribourg
Lüscherz	Bern
Lussery-Villars	Vaud
Lüsslingen	Solothurn
Lussy-sur-Morges	Vaud
Luterbach	Solothurn
Lüterkofen-Ichertswil	Solothurn
Lüterswil-Gächliwil	Solothurn
Luthern	Lucerne
Lütisburg	St. Gallen
Lutry	Vaud
Lütschental	Bern
Lützelflüh	Bern
Lutzenberg	Appenzell Ausserrhoden
Luven	Graubünden
Luzein	Graubünden
Lucerne	Lucerne
Lyss	Bern
Lyssach	Bern
Madiswil	Bern
Madulain	Graubünden
Magden	Aargau
Mägenwil	Aargau
Maggia	Ticino
Magliaso	Ticino
Maienfeld	Graubünden
Mairengo	Ticino
Maisprach	Basel-Landschaft
Maladers	Graubünden
Malans	Graubünden
Malleray	Bern
Malters	Lucerne
Malvaglia	Ticino
Mammern	Thurgau
Mandach	Aargau
Männedorf	Zürich
Manno	Ticino
Maracon	Vaud
Marbach (LU)	Lucerne
Marbach (SG)	St. Gallen
Marchissy	Vaud
Marly	Fribourg
Marmorera	Graubünden
Marnand	Vaud
Maroggia	Ticino
Marsens	Fribourg
Märstetten	Thurgau
Marthalen	Zürich
Martherenges	Vaud
Martigny	Valais
Martigny-Combe	Valais
Martisberg	Valais
Maschwanden	Zürich
Masein	Graubünden
Massagno	Ticino
Massongex	Valais
Massonnens	Fribourg
Mastrils	Graubünden
Mathod	Vaud
Mathon	Graubünden
Matran	Fribourg
Matten bei Interlaken	Bern
Mattstetten	Bern
Matzendorf	Solothurn
Matzingen	Thurgau
Mauborget	Vaud
Mauensee	Lucerne
Maur	Zürich
Mauraz	Vaud
Medel (Lucmagn)	Graubünden
Meggen	Lucerne
Meienried	Bern
Meierskappel	Lucerne
Meikirch	Bern
Meilen	Zürich
Meinier	Geneva
Meinisberg	Bern
Meiringen	Bern
Meisterschwanden	Aargau
Melano	Ticino
Melchnau	Bern
Melide	Ticino
Mellikon	Aargau
Mellingen	Aargau
Mels	St. Gallen
Meltingen	Solothurn
Mendrisio	Ticino
Ménières	Fribourg
Menziken	Aargau
Menzingen	Zug
Menznau	Lucerne
Merenschwand	Aargau
Mergoscia	Ticino
Meride	Ticino
Merishausen	Schaffhausen
Mervelier	Jura
Merzligen	Bern
Mesocco	Graubünden
Messen	Solothurn
Mettauertal	Aargau
Mettembert	Jura
Mettmenstetten	Zürich
Metzerlen-Mariastein	Solothurn
Mex (VD)	Vaud
Mex (VS)	Valais
Meyriez	Fribourg
Meyrin	Geneva
Mézières (FR)	Fribourg
Mézières (VD)	Vaud
Mezzovico-Vira	Ticino
Miège	Valais
Mies	Vaud
Miglieglia	Ticino
Minusio	Ticino
Mirchel	Bern
Misery-Courtion	Fribourg
Missy	Vaud
Möhlin	Aargau
Moiry	Vaud
Moleno	Ticino
Molinis	Graubünden
Mollens (VD)	Vaud
Mollens (VS)	Valais
Molondin	Vaud
Mon	Graubünden
Mönchaltorf	Zürich
Monible	Bern
Monnaz	Vaud
Mont-la-Ville	Vaud
Mont-Noble	Valais
Mont-sur-Rolle	Vaud
Mont-Tramelan	Bern
Montagny (FR)	Fribourg
Montagny-près-Yverdon	Vaud
Montalchez	Neuchâtel
Montana	Valais
Montaubion-Chardonney	Vaud
Montcherand	Vaud
Monte Carasso	Ticino
Monteceneri	Ticino
Monteggio	Ticino
Montet (Glâne)	Fribourg
Montfaucon	Jura
Mönthal	Aargau
Montherod	Vaud
Monthey	Valais
Montmagny	Vaud
Montmollin	Neuchâtel
Montpreveyres	Vaud
Montreux	Vaud
Montricher	Vaud
Montsevelier	Jura
Moosleerau	Aargau
Moosseedorf	Bern
Morbio Inferiore	Ticino
Morcote	Ticino
Mörel-Filet	Valais
Morens (FR)	Fribourg
Morges	Vaud
Mörigen	Bern
Möriken-Wildegg	Aargau
Morissen	Graubünden
Morlon	Fribourg
Morrens (VD)	Vaud
Morschach	Schwyz
Mörschwil	St. Gallen
Mosnang	St. Gallen
Mosogno	Ticino
Mötschwil	Bern
Moudon	Vaud
Moutier	Bern
Movelier	Jura
Muhen	Aargau
Mühlau	Aargau
Mühleberg	Bern
Mühledorf (BE)	Bern
Mühledorf (SO)	Solothurn
Mühlethurnen	Bern
Mülchi	Bern
Mulegns	Graubünden
Müllheim	Thurgau
Mülligen	Aargau
Mümliswil-Ramiswil	Solothurn
Mumpf	Aargau
Münchenbuchsee	Bern
Münchenstein	Basel-Landschaft
Münchenwiler	Bern
Münchringen	Bern
Münchwilen (AG)	Aargau
Münchwilen (TG)	Thurgau
Mund	Valais
Mundaun	Graubünden
Münsingen	Bern
Münster-Geschinen	Valais
Münsterlingen	Thurgau
Muntelier	Fribourg
Müntschemier	Bern
Muolen	St. Gallen
Muotathal	Schwyz
Mur (VD)	Vaud
Muralto	Ticino
Murgenthal	Aargau
Muri (AG)	Aargau
Muri bei Bern	Bern
Muriaux	Jura
Murist	Fribourg
Murten	Fribourg
Mutrux	Vaud
Mutten	Graubünden
Muttenz	Basel-Landschaft
Muzzano	Ticino
Naters	Valais
Naz	Vaud
Nebikon	Lucerne
Neckertal	St. Gallen
Neerach	Zürich
Neftenbach	Zürich
Neggio	Ticino
Nendaz	Valais
Nennigkofen	Solothurn
Nenzlingen	Basel-Landschaft
Nesslau-Krummenau	St. Gallen
Neuchâtel	Neuchâtel
Neudorf	Lucerne
Neuendorf	Solothurn
Neuenegg	Bern
Neuenhof	Aargau
Neuenkirch	Lucerne
Neuhausen am Rheinfall	Schaffhausen
Neuheim	Zug
Neunforn	Thurgau
Neunkirch	Schaffhausen
Neyruz (FR)	Fribourg
Neyruz-sur-Moudon	Vaud
Nidau	Bern
Niederbipp	Bern
Niederbuchsiten	Solothurn
Niederbüren	St. Gallen
Niederdorf	Basel-Landschaft
Niedergesteln	Valais
Niederglatt	Zürich
Niedergösgen	Solothurn
Niederhasli	Zürich
Niederhelfenschwil	St. Gallen
Niederhünigen	Bern
Niederlenz	Aargau
Niedermuhlern	Bern
Niederönz	Bern
Niederösch	Bern
Niederried bei Interlaken	Bern
Niederried bei Kallnach	Bern
Niederrohrdorf	Aargau
Niederstocken	Bern
Niederwald	Valais
Niederweningen	Zürich
Niederwil (AG)	Aargau
Nods	Bern
Noflen	Bern
Noréaz	Fribourg
Nottwil	Lucerne
Novaggio	Ticino
Novalles	Vaud
Novazzano	Ticino
Noville	Vaud
Nufenen	Graubünden
Nuglar-St. Pantaleon	Solothurn
Nunningen	Solothurn
Nürensdorf	Zürich
Nusshof	Basel-Landschaft
Nuvilly	Fribourg
Nyon	Vaud
Oberägeri	Zug
Oberbalm	Bern
Oberbipp	Bern
Oberbözberg	Aargau
Oberbuchsiten	Solothurn
Oberbüren	St. Gallen
Oberburg	Bern
Oberdiessbach	Bern
Oberdorf (BL)	Basel-Landschaft
Oberdorf (NW)	Nidwalden
Oberdorf (SO)	Solothurn
Oberegg	Appenzell Innerrhoden
Oberembrach	Zürich
Oberems	Valais
Oberengstringen	Zürich
Oberentfelden	Aargau
Oberflachs	Aargau
Obergerlafingen	Solothurn
Oberglatt	Zürich
Obergoms	Valais
Obergösgen	Solothurn
Oberhallau	Schaffhausen
Oberhelfenschwil	St. Gallen
Oberhof	Aargau
Oberhofen am Thunersee	Bern
Oberhünigen	Bern
Oberiberg	Schwyz
Oberkirch	Lucerne
Oberkulm	Aargau
Oberlangenegg	Bern
Oberlunkhofen	Aargau
Obermumpf	Aargau
Oberösch	Bern
Oberried am Brienzersee	Bern
Oberrieden	Zürich
Oberriet (SG)	St. Gallen
Oberrohrdorf	Aargau
Oberrüti	Aargau
Obersaxen	Graubünden
Oberschrot	Fribourg
Obersiggenthal	Aargau
Oberstammheim	Zürich
Obersteckholz	Bern
Oberstocken	Bern
Oberthal	Bern
Oberuzwil	St. Gallen
Oberweningen	Zürich
Oberwil (BL)	Basel-Landschaft
Oberwil bei Büren	Bern
Oberwil im Simmental	Bern
Oberwil-Lieli	Aargau
Obfelden	Zürich
Ochlenberg	Bern
Oekingen	Solothurn
Oensingen	Solothurn
Oeschenbach	Bern
Oeschgen	Aargau
Oetwil am See	Zürich
Oetwil an der Limmat	Zürich
Oftringen	Aargau
Ogens	Vaud
Ohmstal	Lucerne
Oleyres	Vaud
Ollon	Vaud
Olsberg	Aargau
Olten	Solothurn
Oltingen	Basel-Landschaft
Onex	Geneva
Onnens (VD)	Vaud
Onsernone	Ticino
Opfikon	Zürich
Oppens	Vaud
Oppligen	Bern
Orbe	Vaud
Orges	Vaud
Origlio	Ticino
Ormalingen	Basel-Landschaft
Ormont-Dessous	Vaud
Ormont-Dessus	Vaud
Orny	Vaud
Oron-la-Ville	Vaud
Oron-le-Châtel	Vaud
Orpund	Bern
Orselina	Ticino
Orsières	Valais
Orvin	Bern
Orzens	Vaud
Osco	Ticino
Osogna	Ticino
Ossingen	Zürich
Ostermundigen	Bern
Otelfingen	Zürich
Othmarsingen	Aargau
Ottenbach	Zürich
Oulens-sous-Échallens	Vaud
Oulens-sur-Lucens	Vaud
Pailly	Vaud
Palézieux	Vaud
Pampigny	Vaud
Paradiso	Ticino
Paspels	Graubünden
Paudex	Vaud
Payerne	Vaud
Peist	Graubünden
Peney-le-Jorat	Vaud
Penthalaz	Vaud
Penthaz	Vaud
Penthéréaz	Vaud
Perly-Certoux	Geneva
Perrefitte	Bern
Perroy	Vaud
Personico	Ticino
Péry	Bern
Peseux	Neuchâtel
Peyres-Possens	Vaud
Pfäfers	St. Gallen
Pfäffikon	Zürich
Pfaffnau	Lucerne
Pfeffikon	Lucerne
Pfeffingen	Basel-Landschaft
Pfungen	Zürich
Pfyn	Thurgau
Pianezzo	Ticino
Pierrafortscha	Fribourg
Pieterlen	Bern
Pigniu	Graubünden
Pitasch	Graubünden
Pizy	Vaud
Plaffeien	Fribourg
Plagne	Bern
Plan-les-Ouates	Geneva
Plasselb	Fribourg
Pleigne	Jura
Pohlern	Bern
Poliez-le-Grand	Vaud
Poliez-Pittet	Vaud
Pollegio	Ticino
Pompaples	Vaud
Pomy	Vaud
Pont-en-Ogoz	Fribourg
Pont-la-Ville	Fribourg
Ponte Capriasca	Ticino
Ponte Tresa	Ticino
Pontenet	Bern
Ponthaux	Fribourg
Pontresina	Graubünden
Porrentruy	Jura
Port	Bern
Port-Valais	Valais
Porza	Ticino
Poschiavo	Graubünden
Prahins	Vaud
Prangins	Vaud
Prato (Leventina)	Ticino
Pratteln	Basel-Landschaft
Pratval	Graubünden
Pregny-Chambésy	Geneva
Prêles	Bern
Premier	Vaud
Preonzo	Ticino
Presinge	Geneva
Préverenges	Vaud
Prévondavaux	Fribourg
Prévonloup	Vaud
Prez-vers-Noréaz	Fribourg
Prilly	Vaud
Provence	Vaud
Puidoux	Vaud
Pully	Vaud
Puplinge	Geneva
Pura	Ticino
Quarten	St. Gallen
Quinto	Ticino
Radelfingen	Bern
Rafz	Zürich
Rain	Lucerne
Ramlinsburg	Basel-Landschaft
Ramosch	Graubünden
Ramsen	Schaffhausen
Rances	Vaud
Randa	Valais
Randogne	Valais
Raperswilen	Thurgau
Rapperswil (BE)	Bern
Rapperswil-Jona	St. Gallen
Raron	Valais
Realp	Uri
Rebeuvelier	Jura
Rebévelier	Bern
Rebstein	St. Gallen
Recherswil	Solothurn
Rechthalten	Fribourg
Reckingen-Gluringen	Valais
Reconvilier	Bern
Regensberg	Zürich
Regensdorf	Zürich
Rehetobel	Appenzell Ausserrhoden
Reichenbach im Kandertal	Bern
Reichenburg	Schwyz
Reiden	Lucerne
Reigoldswil	Basel-Landschaft
Reinach (AG)	Aargau
Reinach (BL)	Basel-Landschaft
Reisiswil	Bern
Reitnau	Aargau
Rekingen (AG)	Aargau
Remaufens	Fribourg
Remetschwil	Aargau
Remigen	Aargau
Renan (BE)	Bern
Renens (VD)	Vaud
Rennaz	Vaud
Reute (AR)	Appenzell Ausserrhoden
Reutigen	Bern
Reverolle	Vaud
Rhäzüns	Graubünden
Rheinau	Zürich
Rheineck	St. Gallen
Rheinfelden	Aargau
Riaz	Fribourg
Richterswil	Zürich
Rickenbach (BL)	Basel-Landschaft
Rickenbach (LU)	Lucerne
Rickenbach (SO)	Solothurn
Rickenbach (TG)	Thurgau
Rickenbach (ZH)	Zürich
Riddes	Valais
Ried bei Kerzers	Fribourg
Ried-Brig	Valais
Rieden	St. Gallen
Riederalp	Valais
Riedholz	Solothurn
Riehen	Basel-Stadt
Riein	Graubünden
Riemenstalden	Schwyz
Rietheim	Aargau
Riex	Vaud
Rifferswil	Zürich
Riggisberg	Bern
Ringgenberg (BE)	Bern
Riniken	Aargau
Riom-Parsonz	Graubünden
Risch	Zug
Riva San Vitale	Ticino
Rivaz	Vaud
Roche (VD)	Vaud
Rochefort	Neuchâtel
Roches (BE)	Bern
Rocourt	Jura
Rodels	Graubünden
Rodersdorf	Solothurn
Roggenburg	Basel-Landschaft
Roggliswil	Lucerne
Roggwil (BE)	Bern
Roggwil (TG)	Thurgau
Rohr (SO)	Solothurn
Rohrbach	Bern
Rohrbachgraben	Bern
Rolle	Vaud
Romainmôtier-Envy	Vaud
Romairon	Vaud
Romanel-sur-Lausanne	Vaud
Romanel-sur-Morges	Vaud
Romanshorn	Thurgau
Römerswil	Lucerne
Romont (BE)	Bern
Romont (FR)	Fribourg
Romoos	Lucerne
Ronco sopra Ascona	Ticino
Rongellen	Graubünden
Root	Lucerne
Ropraz	Vaud
Rorbas	Zürich
Rorschach	St. Gallen
Rorschacherberg	St. Gallen
Röschenz	Basel-Landschaft
Rossa	Graubünden
Rossemaison	Jura
Rossenges	Vaud
Rossens (FR)	Fribourg
Rossinière	Vaud
Röthenbach im Emmental	Bern
Rothenbrunnen	Graubünden
Rothenburg	Lucerne
Rothenfluh	Basel-Landschaft
Rothenthurm	Schwyz
Rothrist	Aargau
Rottenschwil	Aargau
Rougemont	Vaud
Roveredo (GR)	Graubünden
Rovio	Ticino
Rovray	Vaud
Rubigen	Bern
Rüderswil	Bern
Rüdlingen	Schaffhausen
Rudolfstetten-Friedlisberg	Aargau
Rüdtligen-Alchenflüh	Bern
Rue	Fribourg
Rüeggisberg	Bern
Rüegsau	Bern
Rueun	Graubünden
Rueyres	Vaud
Rueyres-les-Prés	Fribourg
Rüfenach	Aargau
Rumendingen	Bern
Rümikon	Aargau
Rumisberg	Bern
Rümlang	Zürich
Rümligen	Bern
Rümlingen	Basel-Landschaft
Rünenberg	Basel-Landschaft
Rupperswil	Aargau
Ruppoldsried	Bern
Rüschegg	Bern
Ruschein	Graubünden
Rüschlikon	Zürich
Russikon	Zürich
Russin	Geneva
Russy	Fribourg
Ruswil	Lucerne
Rüte	Appenzell Innerrhoden
Rüthi (SG)	St. Gallen
Rüti (ZH)	Zürich
Rüti bei Büren	Bern
Rüti bei Lyssach	Bern
Rütschelen	Bern
Rüttenen	Solothurn
S-chanf	Graubünden
Saanen	Bern
Saas im Prättigau	Graubünden
Saas-Almagell	Valais
Saas-Balen	Valais
Saas-Fee	Valais
Saas-Grund	Valais
Sachseln	Obwalden
Safenwil	Aargau
Safien	Graubünden
Safnern	Bern
Sagogn	Graubünden
Saicourt	Bern
Saignelégier	Jura
Saillon	Valais
Saint-Aubin (FR)	Fribourg
Saint-Aubin-Sauges	Neuchâtel
Saint-Barthélemy (VD)	Vaud
Saint-Blaise	Neuchâtel
Saint-Brais	Jura
Saint-Cergue	Vaud
Saint-Cierges	Vaud
Saint-George	Vaud
Saint-Gingolph	Valais
Saint-Imier	Bern
Saint-Légier-La Chiésaz	Vaud
Saint-Léonard	Valais
Saint-Livres	Vaud
Saint-Martin (FR)	Fribourg
Saint-Martin (VS)	Valais
Saint-Maurice	Valais
Saint-Oyens	Vaud
Saint-Prex	Vaud
Saint-Saphorin (Lavaux)	Vaud
Saint-Saphorin-sur-Morges	Vaud
Saint-Sulpice (VD)	Vaud
Sainte-Croix	Vaud
Salenstein	Thurgau
Sâles	Fribourg
Salgesch	Valais
Salins	Valais
Salmsach	Thurgau
Salouf	Graubünden
Salvan	Valais
Salvenach	Fribourg
Samedan	Graubünden
Samnaun	Graubünden
San Vittore	Graubünden
Sant'Antonino	Ticino
Sant'Antonio	Ticino
Santa Maria in Calanca	Graubünden
Sargans	St. Gallen
Sarmenstorf	Aargau
Sarnen	Obwalden
Sarzens	Vaud
Sassel	Vaud
Satigny	Geneva
Sattel	Schwyz
Saubraz	Vaud
Saulcy	Jura
Saules (BE)	Bern
Savagnier	Neuchâtel
Savièse	Valais
Savigny	Vaud
Savognin	Graubünden
Savosa	Ticino
Saxeten	Bern
Saxon	Valais
Schaffhausen	Schaffhausen
Schafisheim	Aargau
Schalunen	Bern
Schangnau	Bern
Schänis	St. Gallen
Scharans	Graubünden
Schattdorf	Uri
Schattenhalb	Bern
Schelten	Bern
Schenkon	Lucerne
Scherz	Aargau
Scheunen	Bern
Scheuren	Bern
Schiers	Graubünden
Schinznach-Bad	Aargau
Schinznach-Dorf	Aargau
Schlans	Graubünden
Schlatt (TG)	Thurgau
Schlatt (ZH)	Zürich
Schlatt-Haslen	Appenzell Innerrhoden
Schleinikon	Zürich
Schleitheim	Schaffhausen
Schlierbach	Lucerne
Schlieren	Zürich
Schlossrued	Aargau
Schlosswil	Bern
Schluein	Graubünden
Schmerikon	St. Gallen
Schmiedrued	Aargau
Schmitten (FR)	Fribourg
Schmitten (GR)	Graubünden
Schnaus	Graubünden
Schneisingen	Aargau
Schnottwil	Solothurn
Schöfflisdorf	Zürich
Schöftland	Aargau
Schönenberg (ZH)	Zürich
Schönenbuch	Basel-Landschaft
Schönengrund	Appenzell Ausserrhoden
Schönenwerd	Solothurn
Schongau	Lucerne
Schönholzerswilen	Thurgau
Schötz	Lucerne
Schübelbach	Schwyz
Schupfart	Aargau
Schüpfen	Bern
Schüpfheim	Lucerne
Schwaderloch	Aargau
Schwadernau	Bern
Schwanden bei Brienz	Bern
Schwarzenberg, Switzerland	Lucerne
Schwarzenburg	Bern
Schwarzhäusern	Bern
Schwellbrunn	Appenzell Ausserrhoden
Schwende	Appenzell Innerrhoden
Schwendibach	Bern
Schwerzenbach	Zürich
Schwyz	Schwyz
Scuol	Graubünden
Seeberg	Bern
Seedorf (BE)	Bern
Seedorf (UR)	Uri
Seegräben	Zürich
Seehof	Bern
Seelisberg	Uri
Seengen	Aargau
Seewen	Solothurn
Seewis im Prättigau	Graubünden
Seftigen	Bern
Seigneux	Vaud
Selma	Graubünden
Seltisberg	Basel-Landschaft
Selzach	Solothurn
Sembrancher	Valais
Sementina	Ticino
Semione	Ticino
Sempach	Lucerne
Semsales	Fribourg
Senarclens	Vaud
Senèdes	Fribourg
Sennwald	St. Gallen
Sent	Graubünden
Seon	Aargau
Sergey	Vaud
Servion	Vaud
Sessa	Ticino
Seuzach	Zürich
Sévaz	Fribourg
Sevelen	St. Gallen
Sévery	Vaud
Sevgein	Graubünden
Siat	Graubünden
Siblingen	Schaffhausen
Sierre	Valais
Siglistorf	Aargau
Signau	Bern
Signy-Avenex	Vaud
Sigriswil	Bern
Silenen	Uri
Sils im Domleschg	Graubünden
Sils im Engadin/Segl	Graubünden
Silvaplana	Graubünden
Simplon	Valais
Sins	Aargau
Sion	Valais
Sirnach	Thurgau
Siselen	Bern
Sisikon	Uri
Sissach	Basel-Landschaft
Sisseln	Aargau
Siviriez	Fribourg
Soazza	Graubünden
Sobrio	Ticino
Solothurn	Solothurn
Sommeri	Thurgau
Sonceboz-Sombeval	Bern
Sonogno	Ticino
Sonvico	Ticino
Sonvilier	Bern
Soral	Geneva
Sorengo	Ticino
Sorens	Fribourg
Sornetan	Bern
Sorvilier	Bern
Sottens	Vaud
Soubey	Jura
Souboz	Bern
Soulce	Jura
Soyhières	Jura
Speicher	Appenzell Ausserrhoden
Spiez	Bern
Spiringen	Uri
Splügen	Graubünden
Spreitenbach	Aargau
St. Antoni	Fribourg
St. Antönien	Graubünden
St. Gallen	St. Gallen
St. Gallenkappel	St. Gallen
St. Margrethen	St. Gallen
St. Martin	Graubünden
St. Moritz	Graubünden
St. Niklaus	Valais
St. Peter-Pagig	Graubünden
St. Silvester	Fribourg
St. Stephan	Bern
St. Ursen	Fribourg
Stabio	Ticino
Stadel bei Niederglatt	Zürich
Stäfa	Zürich
Staffelbach	Aargau
Stalden (VS)	Valais
Staldenried	Valais
Stallikon	Zürich
Stans	Nidwalden
Stansstad	Nidwalden
Starrkirch-Wil	Solothurn
Staufen	Aargau
Steckborn	Thurgau
Steffisburg	Bern
Steg-Hohtenn	Valais
Stein (AG)	Aargau
Stein (AR)	Appenzell Ausserrhoden
Stein (SG)	St. Gallen
Stein am Rhein	Schaffhausen
Steinach	St. Gallen
Steinen	Schwyz
Steinerberg	Schwyz
Steinhausen	Zug
Steinhof	Solothurn
Steinmaur	Zürich
Sternenberg	Zürich
Stetten (AG)	Aargau
Stetten (SH)	Schaffhausen
Stettfurt	Thurgau
Stettlen	Bern
Stierva	Graubünden
Strengelbach	Aargau
Studen (BE)	Bern
Stüsslingen	Solothurn
Subingen	Solothurn
Suchy	Vaud
Sufers	Graubünden
Sugnens	Vaud
Suhr	Aargau
Sulgen	Thurgau
Sullens	Vaud
Sumiswald	Bern
Sumvitg	Graubünden
Sur	Graubünden
Suraua	Graubünden
Surava	Graubünden
Surpierre	Fribourg
Sursee	Lucerne
Suscévaz	Vaud
Susch	Graubünden
Sutz-Lattrigen	Bern
Syens	Vaud
Tafers	Fribourg
Tägerig	Aargau
Tägertschi	Bern
Tägerwilen	Thurgau
Tamins	Graubünden
Tannay	Vaud
Tarasp	Graubünden
Tartegnin	Vaud
Täsch	Valais
Täuffelen	Bern
Tavannes	Bern
Tecknau	Basel-Landschaft
Tegerfelden	Aargau
Tegna	Ticino
Tenero-Contra	Ticino
Tenna	Graubünden
Tenniken	Basel-Landschaft
Tentlingen	Fribourg
Termen	Valais
Teufen (AR)	Appenzell Ausserrhoden
Teufenthal (AG)	Aargau
Teuffenthal (BE)	Bern
Thal	St. Gallen
Thalheim (AG)	Aargau
Thalheim an der Thur	Zürich
Thalwil	Zürich
Thayngen	Schaffhausen
Therwil	Basel-Landschaft
Thierachern	Bern
Thierrens	Vaud
Thônex	Geneva
Thörigen	Bern
Thun	Bern
Thundorf	Thurgau
Thunstetten	Bern
Thürnen	Basel-Landschaft
Thusis	Graubünden
Tiefencastel	Graubünden
Tinizong-Rona	Graubünden
Titterten	Basel-Landschaft
Tobel-Tägerschen	Thurgau
Toffen	Bern
Tolochenaz	Vaud
Tomils	Graubünden
Törbel	Valais
Torny	Fribourg
Torricella-Taverne	Ticino
Trachselwald	Bern
Tramelan	Bern
Trasadingen	Schaffhausen
Treiten	Bern
Trélex	Vaud
Trey	Vaud
Treycovagnes	Vaud
Treytorrens (Payerne)	Vaud
Treyvaux	Fribourg
Triengen	Lucerne
Trient	Valais
Trimbach	Solothurn
Trimmis	Graubünden
Trimstein	Bern
Trin	Graubünden
Trogen	Appenzell Ausserrhoden
Troinex	Geneva
Troistorrents	Valais
Trub	Bern
Trubschachen	Bern
Trüllikon	Zürich
Trun	Graubünden
Truttikon	Zürich
Tschappina	Graubünden
Tscheppach	Solothurn
Tschiertschen-Praden	Graubünden
Tschlin	Graubünden
Tschugg	Bern
Tübach	St. Gallen
Tuggen	Schwyz
Tujetsch	Graubünden
Turbenthal	Zürich
Turgi	Aargau
Turtmann	Valais
Twann-Tüscherz	Bern
Udligenswil	Lucerne
Ueberstorf	Fribourg
Uebeschi	Bern
Ueken	Aargau
Uerkheim	Aargau
Uesslingen-Buch	Thurgau
Uetendorf	Bern
Uetikon am See	Zürich
Uezwil	Aargau
Ufhusen	Lucerne
Uitikon	Zürich
Ulmiz	Fribourg
Undervelier	Jura
Unterägeri	Zug
Unterbäch	Valais
Unterbözberg	Aargau
Untereggen	St. Gallen
Unterems	Valais
Unterendingen	Aargau
Unterengstringen	Zürich
Unterentfelden	Aargau
Unteriberg	Schwyz
Unterkulm	Aargau
Unterlangenegg	Bern
Unterlunkhofen	Aargau
Unterramsern	Solothurn
Unterschächen	Uri
Unterseen	Bern
Untersiggenthal	Aargau
Unterstammheim	Zürich
Untervaz	Graubünden
Urdorf	Zürich
Urmein	Graubünden
Urnäsch	Appenzell Ausserrhoden
Ursenbach	Bern
Ursins	Vaud
Ursy	Fribourg
Urtenen-Schönbühl	Bern
Uster	Zürich
Uttigen	Bern
Uttwil	Thurgau
Utzenstorf	Bern
Uznach	St. Gallen
Uzwil	St. Gallen
Vacallo	Ticino
Val Müstair	Graubünden
Val-d'Illiez	Valais
Val-de-Travers	Neuchâtel
Valangin	Neuchâtel
Valcolla	Ticino
Valendas	Graubünden
Valeyres-sous-Montagny	Vaud
Valeyres-sous-Rances	Vaud
Valeyres-sous-Ursins	Vaud
Vallamand	Vaud
Vallon	Fribourg
Vallorbe	Vaud
Vals	Graubünden
Vandoeuvres	Geneva
Varen	Valais
Vauffelin	Bern
Vaugondry	Vaud
Vaulion	Vaud
Vaulruz	Fribourg
Vaumarcus	Neuchâtel
Vaux-sur-Morges	Vaud
Vaz/Obervaz	Graubünden
Vechigen	Bern
Vella	Graubünden
Vellerat	Jura
Veltheim (AG)	Aargau
Vendlincourt	Jura
Venthône	Valais
Verdabbio	Graubünden
Vergeletto	Ticino
Vermes	Jura
Vernate	Ticino
Vernay	Fribourg
Vernayaz	Valais
Vernier	Geneva
Vérossaz	Valais
Versam	Graubünden
Verscio	Ticino
Versoix	Geneva
Vétroz	Valais
Vevey	Vaud
Vex	Valais
Veyras	Valais
Veyrier	Geneva
Veysonnaz	Valais
Veytaux	Vaud
Vezia	Ticino
Vich	Vaud
Vico Morcote	Ticino
Vicques	Jura
Vignogn	Graubünden
Villarepos	Fribourg
Villars-Bramard	Vaud
Villars-Burquin	Vaud
Villars-Epeney	Vaud
Villars-le-Comte	Vaud
Villars-le-Grand	Vaud
Villars-le-Terroir	Vaud
Villars-Mendraz	Vaud
Villars-Sainte-Croix	Vaud
Villars-sous-Champvent	Vaud
Villars-sous-Yens	Vaud
Villars-sur-Glâne	Fribourg
Villars-Tiercelin	Vaud
Villarsel-sur-Marly	Fribourg
Villarzel	Vaud
Villaz-Saint-Pierre	Fribourg
Villeneuve (FR)	Fribourg
Villeneuve (VD)	Vaud
Villeret	Bern
Villette (Lavaux)	Vaud
Villiers	Neuchâtel
Villigen	Aargau
Villmergen	Aargau
Villnachern	Aargau
Villorsonnens	Fribourg
Vilters-Wangs	St. Gallen
Vinelz	Bern
Vinzel	Vaud
Vionnaz	Valais
Visp	Valais
Visperterminen	Valais
Vitznau	Lucerne
Vogorno	Ticino
Volken	Zürich
Volketswil	Zürich
Vollèges	Valais
Vordemwald	Aargau
Vorderthal	Schwyz
Vouvry	Valais
Vrin	Graubünden
Vuadens	Fribourg
Vuarmarens	Fribourg
Vuarrens	Vaud
Vucherens	Vaud
Vufflens-la-Ville	Vaud
Vufflens-le-Château	Vaud
Vugelles-La Mothe	Vaud
Vuibroye	Vaud
Vuissens	Fribourg
Vuisternens-devant-Romont	Fribourg
Vuisternens-en-Ogoz	Fribourg
Vuiteboeuf	Vaud
Vulliens	Vaud
Vullierens	Vaud
Wachseldorn	Bern
Wädenswil	Zürich
Wagenhausen	Thurgau
Wahlen	Basel-Landschaft
Walchwil	Zug
Wald (AR)	Appenzell Ausserrhoden
Wald (BE)	Bern
Wald (ZH)	Zürich
Waldenburg	Basel-Landschaft
Wäldi	Thurgau
Waldkirch	St. Gallen
Waldstatt	Appenzell Ausserrhoden
Walenstadt	St. Gallen
Walkringen	Bern
Wallbach	Aargau
Wallenried	Fribourg
Wallisellen	Zürich
Walliswil bei Niederbipp	Bern
Walliswil bei Wangen	Bern
Walperswil	Bern
Waltalingen	Zürich
Waltensburg/Vuorz	Graubünden
Waltenschwil	Aargau
Walterswil (BE)	Bern
Walterswil (SO)	Solothurn
Walzenhausen	Appenzell Ausserrhoden
Wangen (SZ)	Schwyz
Wangen an der Aare	Bern
Wangen bei Olten	Solothurn
Wangen-Brüttisellen	Zürich
Wangenried	Bern
Wängi	Thurgau
Wartau	St. Gallen
Warth-Weiningen	Thurgau
Wassen	Uri
Wasterkingen	Zürich
Wattenwil	Bern
Wattwil	St. Gallen
Wauwil	Lucerne
Weesen	St. Gallen
Wegenstetten	Aargau
Weggis	Lucerne
Weiach	Zürich
Weinfelden	Thurgau
Weiningen (ZH)	Zürich
Weisslingen	Zürich
Welschenrohr	Solothurn
Wengi	Bern
Wenslingen	Basel-Landschaft
Werthenstein	Lucerne
Wettingen	Aargau
Wettswil am Albis	Zürich
Wetzikon (ZH)	Zürich
Wichtrach	Bern
Widen	Aargau
Widnau	St. Gallen
Wiedlisbach	Bern
Wiesendangen	Zürich
Wiggiswil	Bern
Wigoltingen	Thurgau
Wikon	Lucerne
Wil (SG)	St. Gallen
Wil (ZH)	Zürich
Wila	Zürich
Wilchingen	Schaffhausen
Wildberg	Zürich
Wilderswil	Bern
Wildhaus-Alt St. Johann	St. Gallen
Wilen (TG)	Thurgau
Wiler (Lötschen)	Valais
Wiler bei Utzenstorf	Bern
Wileroltigen	Bern
Wiliberg	Aargau
Willadingen	Bern
Willisau	Lucerne
Wimmis	Bern
Windisch	Aargau
Winkel	Zürich
Wintersingen	Basel-Landschaft
Winterthur	Zürich
Winznau	Solothurn
Wisen (SO)	Solothurn
Wislikofen	Aargau
Wittenbach	St. Gallen
Witterswil	Solothurn
Wittinsburg	Basel-Landschaft
Wittnau	Aargau
Wohlen (AG)	Aargau
Wohlen bei Bern	Bern
Wohlenschwil	Aargau
Wolfenschiessen	Nidwalden
Wolfhalden	Appenzell Ausserrhoden
Wolfisberg	Bern
Wölflinswil	Aargau
Wolfwil	Solothurn
Wolhusen	Lucerne
Wollerau	Schwyz
Worb	Bern
Worben	Bern
Wünnewil-Flamatt	Fribourg
Wuppenau	Thurgau
Würenlingen	Aargau
Würenlos	Aargau
Wynau	Bern
Wynigen	Bern
Wyssachen	Bern
Yens	Vaud
Yverdon-les-Bains	Vaud
Yvonand	Vaud
Yvorne	Vaud
Zauggenried	Bern
Zäziwil	Bern
Zeglingen	Basel-Landschaft
Zeihen	Aargau
Zeiningen	Aargau
Zell (LU)	Lucerne
Zell (ZH)	Zürich
Zeneggen	Valais
Zermatt	Valais
Zernez	Graubünden
Zetzwil	Aargau
Ziefen	Basel-Landschaft
Zielebach	Bern
Zihlschlacht-Sitterdorf	Thurgau
Zillis-Reischen	Graubünden
Zizers	Graubünden
Zofingen	Aargau
Zollikofen	Bern
Zollikon	Zürich
Zuchwil	Solothurn
Zufikon	Aargau
Zug	Zug
Zullwil	Solothurn
Zumholz	Fribourg
Zumikon	Zürich
Zunzgen	Basel-Landschaft
Zuoz	Graubünden
Zürich	Zürich
Zuzgen	Aargau
Zuzwil (BE)	Bern
Zuzwil (SG)	St. Gallen
Zweisimmen	Bern
Zwieselberg	Bern
Zwingen	Basel-Landschaft
Zwischbergen	Valais